1111111111111111111111
1110001000C00000000001
1P00011110000000100001
10000000C0111111111111
1E001111000000000000C1
1111111111111111111111