11111111111111111
10000000000000001
100P00000C0010001
100000001111000E1
10000000100010001
100C00000000C0001
11111111111111111